configure_args="@CONFIGURE_ARGS@"
rootdir="@ROOTDIR@"
prefix="@prefix@"
exec_prefix="@exec_prefix@"
bindir="@bindir@"
libdir="@libdir@"
datarootdir="@datarootdir@"
mandir="@mandir@"
datadir="@datadir@"
ocamldir="@ocamldir@"
metadir="@metadir@"
ocamlversion="@OCAMLVERSION@"
ocamlc="@OCAMLC@"
ocamlopt="@OCAMLOPT@"
ocamldep="@OCAMLDEP@"
ocamlmktop="@OCAMLMKTOP@"
ocamlmklib="@OCAMLMKLIB@"
ocamldoc="@OCAMLDOC@"
ocamllib="@OCAMLLIB@"
ocamlbin="@OCAMLBIN@"
package_name="@PACKAGE_NAME@"
package_version="@PACKAGE_VERSION@"
cppflags="@CPPFLAGS@"
cxxflags="@CXXFLAGS@"
cflags="@CFLAGS@"
libs="@LIBS@"
cxx="@CXX@"
cc="@CC@"
wx_version="@WX_VERSION@"
wxocaml_has_wrapsizer="@WXOCAML_HAS_WRAPSIZER@"
wxocaml_has_stc="@WXOCAML_HAS_STC@"
